10;10
&;&;&;&;+;И;&;&;&;&
&;.;.;&;+;+;&;&;&;&
&;&;.;&;+;+;&;&;&;&
.;.;.;.;.;+;.;.;.;.
.;.;.;#;+;+;#;.;.;.
.;.;.;.;+;+;.;#;#;#
?;?;?;?;+;+;?;?;?;?
?;?;?;?;+;+;?;?;?;?
?;?;?;?;+;+;?;?;?;?
?;?;?;?;+;К;?;?;?;?
